1111111111111
1E0000000C001
1C110000000C1
1000011111001
1P00110000001
1111111111111
